Time;RS0;RS1;L0R;L0G;L0B;
0;0,7;0;0;0;0;
1;7,3;0;255;255;255;
2;14;6,7;255;255;255;
3;20,7;13,3;0;255;0;
4;20,7;20;0;255;0;
5;20,7;26,7;255;255;0;
6;20,7;20;255;255;0;
7;20,7;13,3;255;255;255;
8;20,7;20;255;255;255;
10;20,7;33,3;255;0;255;
12;7,3;46,7;255;0;255;
14;20,7;60;255;0;255;
15;27,3;60;255;0;255;
16;34;60;0;0;0;
17;40,7;60;255;0;255;
